1 13 31
###############################
#p     ** *    * 2 *  * * *   #
# # # #*# # ###*# # # #*#*#*# #
#  x*     ***  *      * 2 * * #
# **  # # #*# # #*#*# # # # #*#
#    1     x **  *  *         #
# *  * # **  * #  #*# #**  *  #
#*  *      *  *      *        #
# # # # #*# # # #*#*# # * # * #
#*    **  *       *           #
# **# # # *   *  *# # # # # # #
#           *   *  *          #
###############################