1 13 31
###############################
#p*   *                       #
# * 2 * ##################### #
# *   * #                     #
# #***# # #***# #**********#  #
#       # *   * *   *B*    *  #
# #***# # * 1 * *  1    2  *  #
# *   * # *   * *       2  *  #
# * 1 * # #***# #**********#  #
# *   * #                     #
# #***# #*#####*#####*#########
#       #                    x#
###############################