1 13 31
###############################
#                             #
# * * * * *B* * S * * * B * * #
#                             #
# * B * * * * * F *B* * * * * #
#             *             2 #
# * * * * * ***x*** * * * * * #
#           *              3  #
# * *B* * * * * * *** * * * * #
#           *B     3          #
# * * * * * * * * * * * * * * #
#       1   *                 #
###############################