1 13 31
###############################
#p*   *                       #
# * 2 * ##################### #
# *   * #                     #
# #***# # #***# #**********#  #
#       # *   * *   *B*    *  #
# #***# # * 0 * *  0    2  *  #
# *   * # *   * *       2  *  #
# * 1 * # #***# #**********#  #
# *   * #                     #
# #***# #*#####*#####*######x##
#       #                     #
###############################